~~~~~~..............
~~~~~.....@.........
~~~~...@......@.....
~~~..........@......
....................
#######.............
#.....#.............
#.....#.............
....................